E C W W E
E E W W E
E E W W E
E E W W E
E E E E E